AFG - afghanistan
ALB - albania
DZA - algeria
ASM - american-samoa
AND - andorra
AGO - angola
ATG - antigua-and-barbuda
ARG - argentina
ARM - armenia
ABW - aruba
AUS - australia
AUT - austria
AZE - azerbaijan
BHS - bahamas-the
BHR - bahrain
BGD - bangladesh
BRB - barbados
BLR - belarus
BEL - belgium
BLZ - belize
BEN - benin
BMU - bermuda
BTN - bhutan
BOL - bolivia
BIH - bosnia-and-herzegovina
BWA - botswana
BRA - brazil
VGB - british-virgin-islands
BRN - brunei-darussalam
BGR - bulgaria
BFA - burkina-faso
BDI - burundi
CPV - cabo-verde
KHM - cambodia
CMR - cameroon
CAN - canada
CYM - cayman-islands
CAF - central-african-republic
TCD - chad
CHI - channel-islands
CHL - chile
CHN - china
COL - colombia
COM - comoros
COD - congo-dem-rep
COG - congo-rep
CRI - costa-rica
CIV - cote-divoire
HRV - croatia
CUB - cuba
CUW - curacao
CYP - cyprus
CZE - czech-republic
DNK - denmark
DJI - djibouti
DMA - dominica
DOM - dominican-republic
ECU - ecuador
EGY - egypt-arab-rep
SLV - el-salvador
GNQ - equatorial-guinea
ERI - eritrea
EST - estonia
SWZ - eswatini
ETH - ethiopia
FRO - faroe-islands
FJI - fiji
FIN - finland
FRA - france
PYF - french-polynesia
GAB - gabon
GMB - gambia-the
GEO - georgia
DEU - germany
GHA - ghana
GIB - gibraltar
GRC - greece
GRL - greenland
GRD - grenada
GUM - guam
GTM - guatemala
GIN - guinea
GNB - guinea-bissau
GUY - guyana
HTI - haiti
HND - honduras
HKG - hong-kong-sar-china
HUN - hungary
ISL - iceland
IND - india
IDN - indonesia
IRN - iran-islamic-rep
IRQ - iraq
IRL - ireland
IMN - isle-of-man
ISR - israel
ITA - italy
JAM - jamaica
JPN - japan
JOR - jordan
KAZ - kazakhstan
KEN - kenya
KIR - kiribati
PRK - korea-dem-peoples-rep
KOR - korea-rep
XKX - kosovo
KWT - kuwait
KGZ - kyrgyz-republic
LAO - lao-pdr
LVA - latvia
LBN - lebanon
LSO - lesotho
LBR - liberia
LBY - libya
LIE - liechtenstein
LTU - lithuania
LUX - luxembourg
MAC - macao-sar-china
MDG - madagascar
MWI - malawi
MYS - malaysia
MDV - maldives
MLI - mali
MLT - malta
MHL - marshall-islands
MRT - mauritania
MUS - mauritius
MEX - mexico
FSM - micronesia-fed-sts
MDA - moldova
MCO - monaco
MNG - mongolia
MNE - montenegro
MAR - morocco
MOZ - mozambique
MMR - myanmar
NAM - namibia
NRU - nauru
NPL - nepal
NLD - netherlands
NCL - new-caledonia
NZL - new-zealand
NIC - nicaragua
NER - niger
NGA - nigeria
MKD - north-macedonia
MNP - northern-mariana-islands
NOR - norway
OMN - oman
PAK - pakistan
PLW - palau
PAN - panama
PNG - papua-new-guinea
PRY - paraguay
PER - peru
PHL - philippines
POL - poland
PRT - portugal
PRI - puerto-rico
QAT - qatar
ROU - romania
RUS - russian-federation
RWA - rwanda
WSM - samoa
SMR - san-marino
STP - sao-tome-and-principe
SAU - saudi-arabia
SEN - senegal
SRB - serbia
SYC - seychelles
SLE - sierra-leone
SGP - singapore
SXM - sint-maarten-dutch-part
SVK - slovak-republic
SVN - slovenia
SLB - solomon-islands
SOM - somalia
ZAF - south-africa
SSD - south-sudan
ESP - spain
LKA - sri-lanka
KNA - st-kitts-and-nevis
LCA - st-lucia
MAF - st-martin-french-part
VCT - st-vincent-and-the-grenadines
SDN - sudan
SUR - suriname
SWE - sweden
CHE - switzerland
SYR - syrian-arab-republic
TJK - tajikistan
TZA - tanzania
THA - thailand
TLS - timor-leste
TGO - togo
TON - tonga
TTO - trinidad-and-tobago
TUN - tunisia
TUR - turkey
TKM - turkmenistan
TCA - turks-and-caicos-islands
TUV - tuvalu
UGA - uganda
UKR - ukraine
ARE - united-arab-emirates
GBR - united-kingdom
USA - united-states
URY - uruguay
UZB - uzbekistan
VUT - vanuatu
VEN - venezuela-rb
VNM - vietnam
VIR - virgin-islands-us
PSE - west-bank-and-gaza
YEM - yemen-rep
ZMB - zambia
ZWE - zimbabwe
